B:1,PW:1,P1:1,P3:1,P5:1,D:10
M|M|M|M|M|M|M|M|M|M|M|M|M|M|M|M|
M| | |A|A| | | | | | | | | | |M|
M| | |A|A| | | |M|M|M|M| |A| |M|
M| | | | | | | | | | | |A| | |M|
M| | | | | | | | | | | | | | |M|
M| | | | |A|A| | | | |M| | | |M|
M| | | | |A|A|A| |M|M|M| | | |M|
M| | | | |A| | | | | | | | | |M|
M| | | | |A|A| | | | |M| |M| |M|
M| |M|M| | |A| | | |M|M| |M| |M|
M|M| | |M| |A| | | | |M| |M| |M|
M|M|M|M|M|M|M|M|M|M|M|M|M|M|M|M|