B:1,PW:1,P1:1,P3:1,P5:5,D:10
M|M|M|M|M|M|M|M|M|M|M|M|M|M|M|M|
M| | | | | | | | | | | | | | |M| 
M| | | | | | | | | | | | | | |M|
M| | | | | | | | | | | | | | |M|
M| | | | | |A| | | | | | | | |M|
M| | | | | | | | | | | | | | |M|
M| | | | | | | | | | | | | | |M|
M| | | | | | | | | | | | | | |M|
M| | | | | | | | | | | | | | |M|
M| | | | | | | | | | | | | | |M|
M| | | | | | | | | | | | | | |M|
M|M|M|M|M|M|M|M|M|M|M|M|M|M|M|M|